EA ./textures/E.xpm
WE ./textures/W.xpm
SO ./textures/S.xpm
NO ./textures/N.xpm

F 220,100,0
C 225,30,0


11111 1111111
1000111000111
11100010011          1
  100N1001          101
1110001011           1
11 111011   1
1111 111  1 
             
               
111111111111111111111111111111111111111111111111111111111111111111111111111111111111111111111111111111111111111111111111111111111111111111111111111111
100000000000000000000000000000000000000000000000000000000000000000000000000000000000000000000000000000000000000000000000000000000000000000000000000001
111111111111111111111111111111111111111111111111111111111111111111111111111111111111111111111111111111111111111111111111111111111111111111111111111111