1111111111111
1N11000000001
1000011111011
100011000001
