NO ./maps/map.cub
SO ./maps/map.cub
WE ./maps/map.cub
EA ./maps/map.cub

F 220,100,0
C 225,30,0


11111 1111111
1N111 1000111
1100111011           1
  10000111          101
111111111            1
1001  11 1  1
1111  11 1 1
             
               
1111111111
1000000001
1111111111