1111111111111
1111111  1101
1001001111
1P0111100111
111111111
